111111111111111111111111111111111111
1000P000C000000000000000000000000001
1E000000000000000000C000000000000001
100C0C0000001000000000000000000C0001
100000000000100000001111110000000001
1000000C000011111000000C010C00001111
10000000000010C0001110000100000C1C01
111111111111111111111111111111111111