1111111
1000P01
1E00001
100C0C1
1111111