111111111111111111
1000C000000C000001
100000P00C00001111
1000000000000000E1
100000000000001001
111111111111111111