111111111111111111
1000P000C000000001
10000C000000E00001

111111111111111111