111111111111111111
1000C000000C000001
1000P0000C00E00101
111111111111111111