111111111111111111
100C0000C00000C001
10000P000C000001E1
111111111111111111